##################
#@      o        #
#   b   ##       #
#       ##       #
##################